C 255,0,0
F 255,255,255

NO ./textures/eagle.xpm
SO ./textures/greystone.xpm
WE ./textures/purplestone.xpm
EA ./textures/red.xpm


1111111111111111111111111
1000000000110000000000001
1011000001111000000000001
10010000000000000000000011111111
111111111011000001110000000000001
100000000011000001110111111111111
1111011111111101110000001000111
11110111111111011101010010001
11000000110101011100000010001
10000000000000001100000010001
10N0000000000000101010010001
1100000111010101111101111000111
11110111 1110101 101111010001
11111111 1111111 11111111111
             




