NO ./textures/eagle.xpm
SO ./textures/eagle.xpm
WE ./textures/eagle.xpm
EA ./textures/eagle.xpm
F 0,10,00
C 0,0,100

111111111111111111111111
1E00000000000000000000011
1111000000000000000000001
1000000000000000000000011
100000000000000000000000
100000000000000000000001
100000000001000000000001
100000000000100000000001
100000000001000000000001
111111111111111111111111