C  30,144,255
NO      ./textures/eagle.xpm
SO ./textures/greystone.xpm
EA ./textures/purplestone.xpm
WE ./textures/red.xpm

F  128,128,128

111111111111111111111111111111
111111111000100000000000011111
100000000000000000111000100001
110000100000000000000000001111
100001111111000000010000111111
1111111000000000W0000000000001
111100000000001100000001000011
111111111111111111111111111111
1111110000000000011110000000001
10000000000011100000000000001111
110000000000111000000000001111
110000000001111000000000000111
111111111111111111111111111111111
